TILEMAP
36 28 							-- Size of tile map in tiles
16 32 							-- Tile size & block size
images/blocks.png 				-- Tilesheet
2 2 							-- Number of tiles in tilesheet
111111111111111111111111111111111111
11                                11
11                                11
11                                11
11                                11
11                                11
11        2222224224222222        11
11              1111              11
11              1111              11
11              1111              11
11     2222222221111222222222     11
11              1111              11
11              1111              11
11              1111              11
11   22222222222111122222222222   11
11                                11
11                                11
11                                11
11   22422                22422   11
11                                11
11                                11
11                                11
11   222                    222   11
11                                11
11                                11
11                                11
1144222222222          2222222224411
111111111111144444444441111111111111

